#,#,#,#,#,#,#,#,#,#,#
#,S,#, , ,E, ,E, ,*,#
#, ,#, ,#,#,#,#,#,#,#
#, ,#, , , , , , , ,#
#, ,#,#,#,#,#,#,#, ,#
#, , , , , , , , , ,#
#,#,#,#,#,#,#, ,#,#,#
#, , , , , , , , , ,#
#, ,#,#,#,#,#,#,#,#,#
#, , , ,#, , , , , ,#
#,#,#,#,#,#,#,#,#,#,#